10 10 10 10 10 1 1 1 1 1 1 1 6 1 1 1
10 10 10 0 0 0 0 0 0 0 0 0 0 0 0 4
1 0 0 0 0 0 0 0 0 0 0 0 0 0 0 1
1 0 0 0 0 0 0 1 1 0 0 0 0 0 0 1
1 0 0 0 0 0 0 1 8 0 0 0 0 0 0 1
2 0 0 0 0 0 0 1 1 0 0 0 0 0 0 3
1 0 0 0 0 0 0 1 1 0 0 0 0 0 0 1
1 0 0 0 0 0 0 9 1 0 0 0 0 0 0 1
5 0 0 0 0 0 0 1 1 0 0 0 0 0 0 7
1 0 0 0 0 0 0 1 1 0 0 0 0 0 0 1
1 0 0 0 0 0 0 1 1 0 0 0 0 0 0 1
1 1 1 1 1 1 1 1 1 1 1 1 1 1 1 1